000000000000000
111000000000000
222200000000000
333330000000000
111111000000000
222222200000000
333333330000000
111111111000000
222222222200000
333333333330000
111111111111000
222222222222200
333333333333330
555555555555551
