000000000000000
333333333333333
000000000000000
222222222222222
000000000000000
111111111111111
000000000000000
333333333333333
000000000000000
222222222222222
000000000000000
111111111111111
