000000000000000
044444444444440
041111111111140
041000000000140
041033333330140
041022222220140
041011111110140
041022222220140
041033333330140
041055555550140
041000000000140
041111111111140
044444444444440