044444444444440
041111141111140
041111141111140
041111141111140
041111141111140
041111141111140
041111141111140
041111141111140
041111141111140
041111141111140
041111141111140
041111141111140
041111145555540
044444444444440