044444444444440
041111141111140
041111141111140
041111141111140
041111141111140
041111141111140
041111141111140
041111141111140
041111141111140
041111141111140
041111141111140
041111141111140
045555545555540
044444444444440