555555555555555
501121151121105
501121151121105
502232252232205
502232252232205
503343353343305
503343353343305
500000000000005
500000000000005
500220050022005
500110050011005
500000000000005
500000000000005
