000000000000000
011111111111110
012222222222210
012333333333210
012311111113210
012312222213210
012312333213210
012312313213210
012312333213210
012312222213210
012311111113210
012333333333210
012222222222210
011111111111110
